Issues	Julia Michaels
Don’t wanna know	Maroon 5
Cold Water	Major Lazer
Say It	Tory Lanez
Same Old Love	Selena Gomez
Kill Em with Kindness	Selena Gomez
Animals	Maroon 5
Maps	Maroon 5
California Gurls	Katy Perry
Tik Tok	Ke$ha
Dynamite	Taio Cruz
I Kissed a Girl	Katy Perry
Quit	Cashmere Cat
Nights With You	MØ
Love	Lana Del Rey
True Colors	The Weeknd
Fire and the Flood	Vance Joy
At My Best	Machine Gun Kelly
Moves Like Jagger	Maroon 5
Black Widow	Iggy Azalea