Starboy	The Weeknd
I Feel It Coming	The Weeknd
False Alarm	The Weeknd
Greenlight	Pitbull
Ainâ€™t Your Mama	Jennifer Lopez
Locked Away	R. City
Sugar	Maroon 5
Low	Juicy J
Shower	Becky G
Wild Wild Love	Pitbull
Ugly Heart	G.R.L.
Timber	Pitbull
Give It 2 U	Robin Thicke
Wrecking Ball	Miley Cirus
Roar	Katy Perry
You Da One	Rihanna
Where Have You Been	Rihanna
Good Feeling	Flo Rida
Domino	Jessie J
The Night is Still Young	Nicki Minaj